NO ./textures/map/wall_north.png
SO ./textures/map/wall_south.png
WE ./textures/map/wall_west.png
EA ./textures/map/wall_east.png

C 30,136,243
F 207,207,207

1111111111111111111111111111111111111
1000000000000000000000000000000000001
1000000000000000000000000000000000001111111111111111111111111
1000000000000000000000000000000000000000000000000000000000001
1000000000000000000000000000000000001111111111111111111110111
1000000000000000000000000000000000001
1000000000000000000000000000000000001
1000000000000000000000000000000000001
1000000000000000000000000000000000001
1000000000000000000000000000000000001
1000000000000000000000000000000000001
1000000000000000000000000000000000001
1000000000000000000000000000000000001
1000000000000000000000000000000000001
1000000000000000000000000000000000001
1N00000000000000000000000000000000001
1111111111111111111111111111111111111