NO ./textures/wall_wall.png
SO ./textures/wall_south.png
WE ./textures/wall_west.png
EA ./textures/wall_east.png

C 30,136,243
F 207,207,207

111111111111111111111111111111111111111111111111111111111111111111111111111111111111111111111111111111111111111111111111111111111111
1000000000000000000000000000000000E0000000000000000000000000000000000000000000000000000000000000000000000000000000000000000000000001
111111111111111111111111111111111111100000000000000000000000000000000000000000000000000000000000000000000000000000000000000000000001
                                    100000000000000000000000000000000000323232300000000000000000000000000000000000000000000000000001
                                    100000100200300400000000000000000000D00000200000000000000000001002003004005000000000000000000001
                                    100000000000000000000000000000000000323232300000000000000000000000000000000000000000000000000001
                                    100000000000000000000000000000000000000000000000000000000000000000000000000000000000000000000001
      111111111111111111111111111111100000000000000000000000000000000000000000000000000000000000000000000000000000000000000000000001
      100000000000000000000000000000000000000000000000000000000000000000000000000000000000000000000000000000000000000000000000000001
      100000000000000000000000000000000000111111111111111111111111111111111111111111111111111111111111111111111111111111111111111111
      1000000000000000000000000000000000001
      1000000000000000000000000000000000001
      1000000000000000000000000000000000001
      1000000000000000000000000000000000001
      1111011111111111100011111111111111111
         101          10001
         101          10001
    11111101          10001
    10000001          10001
    10111111    11111110001111111
    101         10000000000000001
    101         10000000000000001
    101         10010011111001001
    101         10010010001001001
    101         10010010001001001
    101         10010010001001001
    10111111111110010000001001001
    10000000000000010000001000001
    11111111111111111111111111111