NO ./textures/map/wall_north.png
SO ./textures/map/wall_south.png
WE ./textures/map/wall_west.png
EA ./textures/map/wall_east.png

C 30,136,243
F 207,207,207

1111111111111111111111111111111111111111111111111111111111111111111111111
10000000000000000000000000000000000E0000000000000000000000000000000000001
1111111111111111111111111111111111111000000000000000000000000000000000001
                                    1000000000000000000000000000000000001
                                    1000000000000000000000000000000000001
                                    1000000000000000000000000000000000001
                                    1000000000000000000000000000000000001
      1111111111111111111111111111111000000000000000000000000000000000001
      1000000000000000000000000000000000000000000000000000000000000000001
      1000000000000000000000000000000000001111111111111111111111111111111
      1000000000000000000000000000000000001
      1000000000000000000000000000000000001
      1000000000000000000000000000000000001
      1000000000000000000000000000000000001
      1111011111111111100011111111111111111
         101          10001
         101          10001
    11111101          10001
    10000001          10001
    10111111    11111110001111111
    101         10000000000000001
    101         10000000000000001
    101         10010011111001001
    101         10010010001001001
    101         10010010001001001
    101         10010010001001001
    10111111111110010000001001001
    10000000000000010000001000001
    11111111111111111111111111111