NO ./textures/wall_wall.png
SO ./textures/wall_south.png
WE ./textures/wall_west.png
EA ./textures/wall_east.png

C 30,136,243
F 207,207,207

111111111111111111111111111111111111111111111111111111111111111111111111111111111111111111111111111111111111111111111111111111111111111111111111111111111111111
1E0000000000000000000000000000000000000000000000000000000000000000000000000000000000000000000000000000000000000000000000000000000000000000000000000000000000001
100000000000000000000000000000000000000000000000000000000000000000000000000000000000000000000000000000000000000000000000000000000000000000000000000000000000001
100111000111000111000111000111000111000111000111000111000111000111000111000111000111000111000111000111000111000111000111000111000111000111000111000111000111001
100100000000000000000000000000000000000000000000000000000000000000000000000000000000000000000000000000000000000000000000000000000000000000000000000000000001001
100100000000000000000000000000000000000000000000000000000000000000000000000000000000000000000000000000000000000000000000000000000000000000000000000000000001001
100100000000000000000000000000000000000000000000000000000000000000000000000000000000000000000000000000000000000000000000000000000000000000000000000000000001001
100100000000000000000000000000000000000000000000000000000000000000000000000000000000000000000000000000000000000000000000000000000000000000000000000000000001001
100100000000000000000000000000000000000000000000000000000000000000000000000001111110000000000000000000000000000000000000000000000000000000000000000000000001001
100100000000000000000000000000000000000000000000000000000000000000000000000001222210000000000000000000000000000000000000000000000000000000000000000000000001001
100100000000000000000000000000000000000000000000000000000000000000000000000001233210000000000000000000000000000000000000000000000000000000000000000000000001001
100100000000000000000000000000000000000000000000000000000000000000000000000001222210000000000000000000000000000000000000000000000000000000000000000000000001001
100100000000000000000000000000000000000000000000000000000000000000000000000001111110000000000000000000000000000000000000000000000000000000000000000000000001001
100100000000000000000000000000000000000000000000000000000000000000000000000000000000000000000000000000000000000000000000000000000000000000000000000000000001001
100100000000000000000000000000000000000000000000000000000000000000000000000000000000000000000000000000000000000000000000000000000000000000000000000000000001001
100100000000000000000000011111111111111111111111111111111111111111111111111111111111111111111111111111111111111111111111111111100000000000000000000000000001001
100100000000000000000000000000000000000000000000000000000000000000000000000000000000000000000000000000000000000000000000000000000000000000000000000000000001001
100100000000000000000000000000000000000000000000000000000000000000000000000000000000000000000000000000000000000000000000000000000000000000000000000000000001001
100100000000000000000000000000012345678998765432100000000000000000000000000000000000000000000000000000000000000000000000000000000000000000000000000000000001001
100100000000000000000000000000012345678998765432100000000000000000000000000000000000000000000000000000000000000000000000000000000000000000000000000000000001001
100100000000000000000000000000012345678998765432100000000000000000000000000000000000000000000000000000000000000000000000000000000000000000000000000000000001001
100100000000000000000000000000012345678998765432100000000000000000000000000000000000000000000000000000000000000000000000000000000000000000000000000000000001001
100100000000000000000000000000000000000000000000000000000000000000000000000000000000000000000000000000000000000000000000000000000000000000000000000000000001001
100100000000000000000000000000000000000000000000000000000000000000000000000000000000000000000000000000000000000000000000000000000000000000000000000000000001001
100100000000000000000000000000000000000000000000000000000000000000000000000000000000000000000000000000000000000000000000000000000000000000000000000000000001001
100111000111000111000111000111000111000111000111000111000111000111000111000111000111000111000111000111000111000111000111000111000111000111000111000111000111001
100000000000000000000000000000000000000000000000000000000000000000000000000000000000000000000000000000000000000000000000000000000000000000000000000000000000001
100000000000000000000000000000000000000000000000000000000000000000000000000000000000000000000000000000000000000000000000000000000000000000000000000000000000001
111111111111111111111111111111111111111111111111111111111111111111111111111111111111111111111111111111111111111111111111111111111111111111111111111111111111111