NO ./textures/north_wall.jpg
SO ./textures/south_wall.jpg
WE ./textures/west_wall.jpg
EA ./textures/west_wall.jpg

C 30, 136, 243
F 207, 207, 207

1111111111111111111111111111111111111111111111111111111111111111111111111
1E00000000000000000000000000000000000000000000000000000000000000000000001
1111111111111111111111111111111111111000000000000000000000000000000000001
                                    1000000000000000000000000000000000001
                                    1000000000000000000000000000000000001
                                    1000000000000000000000000000000000001
                                    1000000000000000000000000000000000001
      1111111111111111111111111111111000000000000000000000000000000000001
      1000000000000000000000000000000000000000000000000000000000000000001
      1000000000000000000000000000000000001111111111111111111111111111111
      1000000000000000000000000000000000001
      1000000000000000000000000000000000001
      1000000000000000000000000000000000001
      1000000000000000000000000000000000001
      1111011111111111100011111111111111111
         101          10001
         101          10001
    11111101          10001
    10000001          10001
    10111111    11111110001111111
    101         10000000000000001
    101         10000000000000001
    101         1001001   1001001
    101         1001001   1001001
    101         1001001   1001001
    101         1001001   1001001
    1011111111111001
    1000000000000001
    1111111111111111