NO ./textures/north_wall.jpg
SO ./textures/south_wall.jpg
WE ./textures/west_wall.jpg
EA ./textures/west_wall.jpg

C 30, 136, 243
F 207, 207, 207

1111111111111111111111111111111111111
1000000000000000000000000000000000001
1000000000000000000000000000000000001
1000000000000000000000000000000000001
1000000000000000000000000000000000001
1000000000000000000000000000000000001
1000000000000000000000000000000000001
1000000000000000000000000000000000001
1000000000000000000000000000000000001
1000000000000000000000000000000000001
1000000000000000000000000000000000001
1000000000000000000000000000000000001
1000000000000000000000000000000000001
1000000000000000000000000000000000001
1000000000000000000000000000000000001
1N00000000000000000000000000000000001
1111111111111111111111111111111111111